# ###########
# #         #
# # # ##### #
# # #     # #
# # ##### ###
#   #   #   #
# ### # ### #
# # #   #   #
# # ### # # #
# # #   # # #
# # # ### # #
#   #     # #
#############
